__________________________________________________________________________________________
|0000||0000000000000000000000000000000||0000000||0000000000000000000000||0000000000000000|
‾‾‾|0|‾‾‾‾‾‾|0||0|‾‾‾‾‾‾‾‾‾‾‾‾‾‾‾‾‾‾|0||0|‾‾‾‾‾‾|0||0|‾‾‾‾‾‾‾‾‾‾‾‾‾‾‾|0|‾‾‾|0|‾‾‾‾‾‾‾‾‾|0|
___|0|______|0||0|__________________|0||0|______|0||0|_______________|0|___|0|_________|0|
|0||0000000||0||0||0000||0000000||0000||0||0000||0||0000000||0||0000||0000||0000||0000||0|
|0|‾‾‾‾‾‾|0||0||0||0|‾‾‾|0||0|‾‾‾|0|‾‾‾|0||0||0||0|‾‾‾‾‾‾|0||0||0||0|‾‾‾|0||0||0||0||0||0|
|0|______|0||0||0||0|___|0||0|___|0|___|0||0||0||0|______|0||0||0||0|___|0||0||0||0||0||0|
|0000000||0||0||0||0000000||0000000||0000||0||0||0000000||0||0||0||0000||0||0||0000||0||0|
‾‾‾‾‾‾|0||0|‾‾‾|0||0|‾‾‾‾‾‾‾‾‾‾‾‾‾‾‾|0||0||0||0|‾‾‾‾‾‾|0||0||0||0|‾‾‾|0||0|‾‾‾‾‾‾‾‾‾|0||0|
______|0||0|___|0||0|_______________|0||0||0||0|______|0||0||0||0|___|0||0|_________|0||0|
|0000000||0000||0||0000||0000000000000||0||0||0||0000||0||0||0||0000||0||0000000000000||0|
|0|‾‾‾|0|‾‾‾|0||0|‾‾‾|0|‾‾‾‾‾‾‾‾‾|0|‾‾‾|0||0||0||0||0||0||0||0|‾‾‾|0||0|‾‾‾‾‾‾‾‾‾‾‾‾‾‾‾|0|
|0|___|0|___|0||0|___|0|_________|0|___|0||0||0||0||0||0||0||0|___|0||0|_______________|0|
|0||0||0000||0000||0||0000000000||0000||0||0||0||0||0000||0||0||0000||0000000000000000||0|
|0||0|‾‾‾|0|‾‾‾‾‾‾|0|‾‾‾‾‾‾‾‾‾|0|‾‾‾|0||0||0||0||0|‾‾‾‾‾‾|0||0||0|‾‾‾‾‾‾‾‾‾‾‾‾‾‾‾|0||0||0|
|0||0|___|0|______|0|_________|0|___|0||0||0||0||0|______|0||0||0|_______________|0||0||0|
|0||0000000||0000000000000000||0||0||0||0||0||0000000000||0||0000||0000||0||0000000||0||0|
|0|‾‾‾‾‾‾|0||0|‾‾‾|0|‾‾‾‾‾‾‾‾‾|0||0||0||0||0|‾‾‾‾‾‾‾‾‾‾‾‾|0||0|‾‾‾|0||0||0||0|‾‾‾‾‾‾|0||0|
|0|______|0||0|___|0|_________|0||0||0||0||0|____________|0||0|___|0||0||0||0|______|0||0|
|0||0000||0||0||0000||0000000000||0000||0||0000||0||0000||0||0000000||0000||0||0000000||0|
|0||0||0||0||0||0||0||0|‾‾‾‾‾‾‾‾‾‾‾‾‾‾‾|0|‾‾‾|0||0||0||0||0|‾‾‾‾‾‾‾‾‾‾‾‾|0||0||0|‾‾‾‾‾‾|0|
|0||0||0||0||0||0||0||0|_______________|0|___|0||0||0||0||0|____________|0||0||0|______|0|
|0000||0||0||0||0||0||0||0||0000000||0000||0000||0||0||0000||0000000||0000||0||0000||0000|
|0|‾‾‾|0|‾‾‾|0||0|‾‾‾|0||0||0||0||0||0|‾‾‾|0|‾‾‾|0||0|‾‾‾‾‾‾|0||0||0||0|‾‾‾|0||0|‾‾‾|0|‾‾‾
|0|___|0|___|0||0|___|0||0||0||0||0||0|___|0|___|0||0|______|0||0||0||0|___|0||0|___|0|___
|0000||0000000||0000||0||0000||0||0||0000000||0000||0000||0||0||0||0||0||0000||0||0000||0|
‾‾‾|0|‾‾‾‾‾‾|0|‾‾‾|0||0|‾‾‾‾‾‾|0||0|‾‾‾|0|‾‾‾‾‾‾|0|‾‾‾|0||0||0||0||0||0||0|‾‾‾|0||0|‾‾‾|0|
___|0|______|0|___|0||0|______|0||0|___|0|______|0|___|0||0||0||0||0||0||0|___|0||0|___|0|
|0||0||0000||0||0000||0000||0000||0000||0000000000||0000||0000||0||0||0||0||0000||0||0000|
|0||0||0||0|‾‾‾|0||0|‾‾‾|0||0|‾‾‾‾‾‾|0||0|‾‾‾‾‾‾|0||0|‾‾‾|0|‾‾‾|0||0||0||0|‾‾‾‾‾‾|0||0||0|
|0||0||0||0|___|0||0|___|0||0|______|0||0|______|0||0|___|0|___|0||0||0||0|______|0||0||0|
|0||0||0||0000000||0||0||0||0||0000||0||0||0000||0||0||0000||0000||0||0||0000000000||0||0|
|0||0||0|‾‾‾‾‾‾‾‾‾|0||0||0||0|‾‾‾|0||0|‾‾‾|0||0|‾‾‾|0||0|‾‾‾|0|‾‾‾|0||0|‾‾‾‾‾‾‾‾‾‾‾‾‾‾‾|0|
|0||0||0|_________|0||0||0||0|___|0||0|___|0||0|___|0||0|___|0|___|0||0|_______________|0|
|0000||0000||0||0000||0||0000||0000||0000000||0000000||0||0000||0||0||0000||0000000000||0|
|0|‾‾‾‾‾‾|0||0||0|‾‾‾|0|‾‾‾‾‾‾|0||0|‾‾‾‾‾‾‾‾‾‾‾‾‾‾‾‾‾‾‾‾‾|0|‾‾‾|0||0|‾‾‾|0||0|‾‾‾‾‾‾|0||0|
|0|______|0||0||0|___|0|______|0||0|_____________________|0|___|0||0|___|0||0|______|0||0|
|0000||0000||0000||0000||0000000||0000000||0000000000000000||0000||0||0||0000||0||0000||0|
‾‾‾|0||0|‾‾‾|0|‾‾‾|0||0||0||0|‾‾‾‾‾‾‾‾‾|0||0||0|‾‾‾‾‾‾‾‾‾‾‾‾|0||0||0||0|‾‾‾‾‾‾|0||0|‾‾‾|0|
___|0||0|___|0|___|0||0||0||0|_________|0||0||0|____________|0||0||0||0|______|0||0|___|0|
|0000||0||0||0||0000||0||0||0||0000000||0||0||0000000000000||0||0000000||0000||0000||0000|
‾‾‾‾‾‾|0||0||0||0|‾‾‾|0||0||0|‾‾‾‾‾‾|0||0||0|‾‾‾‾‾‾‾‾‾‾‾‾|0|‾‾‾‾‾‾‾‾‾|0|‾‾‾|0||0|‾‾‾|0||0|
______|0||0||0||0|___|0||0||0|______|0||0||0|____________|0|_________|0|___|0||0|___|0||0|
|0000000||0||0||0000||0000||0||0000||0000||0000000000||0||0000000000||0000000||0||0000||0|
|0|‾‾‾‾‾‾|0||0|‾‾‾‾‾‾|0|‾‾‾|0||0||0|‾‾‾‾‾‾‾‾‾‾‾‾‾‾‾|0||0|‾‾‾‾‾‾‾‾‾|0|‾‾‾‾‾‾‾‾‾|0||0|‾‾‾|0|
|0|______|0||0|______|0|___|0||0||0|_______________|0||0|_________|0|_________|0||0|___|0|
|0||0||0000||0000000||0||0000||0||0000000000000||0000||0000000000||0000000000||0000||0||0|
|0||0||0||0|‾‾‾‾‾‾|0|‾‾‾|0|‾‾‾|0|‾‾‾‾‾‾‾‾‾‾‾‾|0||0|‾‾‾‾‾‾|0|‾‾‾|0|‾‾‾‾‾‾‾‾‾|0|‾‾‾‾‾‾|0||0|
|0||0||0||0|______|0|___|0|___|0|____________|0||0|______|0|___|0|_________|0|______|0||0|
|0||0000||0||0000||0000||0||0000||0||0000||0000||0||0000000||0||0000||0000||0000000||0000|
|0|‾‾‾‾‾‾|0||0||0|‾‾‾|0||0||0|‾‾‾|0||0||0||0|‾‾‾|0|‾‾‾|0|‾‾‾|0|‾‾‾|0|‾‾‾|0|‾‾‾|0|‾‾‾|0|‾‾‾
|0|______|0||0||0|___|0||0||0|___|0||0||0||0|___|0|___|0|___|0|___|0|___|0|___|0|___|0|___
|0000000||0||0||0000||0000||0000||0000||0||0000||0000000||0000000||0000000||0||0000000||0|
|0|‾‾‾|0||0||0|‾‾‾|0|‾‾‾|0|‾‾‾|0|‾‾‾|0||0|‾‾‾|0|‾‾‾‾‾‾‾‾‾‾‾‾‾‾‾|0|‾‾‾‾‾‾|0||0|‾‾‾‾‾‾‾‾‾|0|
|0|___|0||0||0|___|0|___|0|___|0|___|0||0|___|0|_______________|0|______|0||0|_________|0|
|0000||0||0||0000||0000000000||0000||0||0000||0000000000000000000||0000||0||0000000000000|
‾‾‾|0||0||0|‾‾‾|0|‾‾‾‾‾‾‾‾‾‾‾‾‾‾‾|0|‾‾‾‾‾‾|0|‾‾‾‾‾‾|0|‾‾‾|0|‾‾‾‾‾‾|0||0||0||0|‾‾‾‾‾‾‾‾‾|0|
___|0||0||0|___|0|_______________|0|______|0|______|0|___|0|______|0||0||0||0|_________|0|
|0||0||0||0000||0000||0000000000||0||0000||0000||0000||0||0||0000||0||0||0||0||0000000000|
|0||0||0|‾‾‾|0|‾‾‾|0||0|‾‾‾‾‾‾|0||0||0||0|‾‾‾|0||0|‾‾‾|0||0||0||0||0||0||0||0||0|‾‾‾‾‾‾|0|
|0||0||0|___|0|___|0||0|______|0||0||0||0|___|0||0|___|0||0||0||0||0||0||0||0||0|______|0|
|0||0||0000||0000||0||0000000||0||0000||0000000||0||0000000||0||0000||0||0||0||0||0000000|
|0||0|‾‾‾|0||0||0||0|‾‾‾‾‾‾|0||0|‾‾‾‾‾‾‾‾‾‾‾‾|0||0|‾‾‾‾‾‾‾‾‾|0|‾‾‾‾‾‾|0||0|‾‾‾|0|‾‾‾|0|‾‾‾
|0||0|___|0||0||0||0|______|0||0|____________|0||0|_________|0|______|0||0|___|0|___|0|___
|0000||0000||0||0000||0000||0||0000000000000||0||0000000000||0000000||0||0000||0000||0000|
|0|‾‾‾|0|‾‾‾‾‾‾‾‾‾|0||0||0||0|‾‾‾‾‾‾|0|‾‾‾|0||0|‾‾‾‾‾‾‾‾‾|0||0|‾‾‾‾‾‾|0|‾‾‾|0|‾‾‾|0|‾‾‾|0|
|0|___|0|_________|0||0||0||0|______|0|___|0||0|_________|0||0|______|0|___|0|___|0|___|0|
|0000||0||0000000||0||0||0000||0000000||0||0||0||0000000||0||0||0000000000||0000000||0000|
‾‾‾|0||0||0|‾‾‾|0||0||0|‾‾‾‾‾‾|0|‾‾‾‾‾‾|0||0||0|‾‾‾‾‾‾|0||0||0||0|‾‾‾‾‾‾|0|‾‾‾‾‾‾‾‾‾|0|‾‾‾
___|0||0||0|___|0||0||0|______|0|______|0||0||0|______|0||0||0||0|______|0|_________|0|___
|0||0||0||0000||0||0||0||0000000||0000||0000||0000000||0||0000||0||0000000000000000||0||0|
|0||0||0|‾‾‾|0||0|‾‾‾|0||0|‾‾‾‾‾‾|0||0|‾‾‾‾‾‾‾‾‾‾‾‾|0||0|‾‾‾‾‾‾|0||0|‾‾‾‾‾‾‾‾‾‾‾‾‾‾‾|0||0|
|0||0||0|___|0||0|___|0||0|______|0||0|____________|0||0|______|0||0|_______________|0||0|
|0||0||0||0000||0||0000||0||0000000||0000000000000||0000||0||0000||0000||0000000000||0||0|
|0||0||0||0|‾‾‾|0||0|‾‾‾|0||0|‾‾‾‾‾‾‾‾‾‾‾‾‾‾‾|0|‾‾‾‾‾‾|0||0||0|‾‾‾‾‾‾|0||0|‾‾‾‾‾‾|0||0||0|
|0||0||0||0|___|0||0|___|0||0|_______________|0|______|0||0||0|______|0||0|______|0||0||0|
|0||0||0000||0000||0000||0||0000000000000000||0||0000||0||0||0||0000||0||0000000||0||0000|
|0||0|‾‾‾‾‾‾|0||0|‾‾‾|0||0|‾‾‾‾‾‾‾‾‾‾‾‾‾‾‾|0||0||0||0||0||0||0||0|‾‾‾|0|‾‾‾‾‾‾|0||0|‾‾‾|0|
|0||0|______|0||0|___|0||0|_______________|0||0||0||0||0||0||0||0|___|0|______|0||0|___|0|
|0000||0000000||0000||0||0||0000||0000000||0||0||0||0||0||0||0||0000000||0||0000||0000||0|
|0|‾‾‾|0|‾‾‾‾‾‾‾‾‾|0||0||0||0||0||0||0||0||0||0||0||0||0||0||0||0|‾‾‾‾‾‾|0||0|‾‾‾|0||0||0|
|0|___|0|_________|0||0||0||0||0||0||0||0||0||0||0||0||0||0||0||0|______|0||0|___|0||0||0|
|0000||0||0000||0000||0||0000||0||0||0||0||0||0||0||0||0000||0||0000000000||0||0||0||0||0|
‾‾‾|0||0||0||0|‾‾‾|0||0|‾‾‾‾‾‾|0||0||0||0||0||0||0||0|‾‾‾|0||0|‾‾‾‾‾‾‾‾‾‾‾‾|0||0||0|‾‾‾|0|
___|0||0||0||0|___|0||0|______|0||0||0||0||0||0||0||0|___|0||0|____________|0||0||0|___|0|
|0||0||0000||0000||0||0000000||0||0||0||0||0||0||0||0000||0||0||0000000000||0000||0000||0|
|0||0|‾‾‾‾‾‾‾‾‾|0|‾‾‾‾‾‾‾‾‾|0||0||0||0|‾‾‾|0||0||0|‾‾‾|0||0||0||0|‾‾‾‾‾‾|0|‾‾‾|0|‾‾‾|0||0|
|0||0|_________|0|_________|0||0||0||0|___|0||0||0|___|0||0||0||0|______|0|___|0|___|0||0|
|0000000000000||0000000000000||0000||0000000||0000000||0000||0000000000||0000000000||0000|
‾‾‾‾‾‾‾‾‾‾‾‾‾‾‾‾‾‾‾‾‾‾‾‾‾‾‾‾‾‾‾‾‾‾‾‾‾‾‾‾‾‾‾‾‾‾‾‾‾‾‾‾‾‾‾‾‾‾‾‾‾‾‾‾‾‾‾‾‾‾‾‾‾‾‾‾‾‾‾‾‾‾‾‾‾‾‾‾‾‾
